11111111111111
10010000000C01
10C10000000C01
10000111110001
100011E0000001
10001100000001
10001100000001
10001100000001
10001100000001
10P01100000001
10001100000001
11111111111111