11111111111111
1C01PC10000C01
11000010000CC1
100CC000000E11
11111111111111