11111111111111
1C000C00000C01
11101110001111
100PC010000E11
11111111111111