11111111111111
10C10000000C01
10000111110001
1P0011E0000T01
11111111111111