11111111111111
100C0000000001
10C11000000001
10001111110001
10001100000001
1000110E000001
10000000000001
10001100000C01
101C1100000001
11P11100000001
10C00000000001
11111111111111
