11111111111111
10010000000001
10010000000001
10000111110001
10001100000001
1000110E000001
10001100000001
10001100000C01
10001100000001
10P01100000001
10001100000001
11111111111111