11111111111111
1CC10000000C01
10000111110001
1P0011E00C0001
11111111111111