11111111111111
1CC1PCCCCCCC01
11CCCCCCCCCCC1
10ECCCCCCCCE11
11111111111111